11111111111
10000000001
100000P0E01
11111111111