111111111
1000100C1
100C10PE1
111111111