fd
11111111111
1000C000001
100C00P0E01
11111111111