11111111111
110E000C001
10000C00P1
11111111111