11111111111
1000C000001
100C00P0E00
11111111111