11111111111
10C00000001
100000P0C01
11111111111