111111111111111111111111111111111111111111111111111
1E0000000000000C00000C00000000000000000000000000001
1010010100100000101001000000010100000000000000C0001
101001001010101000100100000001010000000000000000001
1P0000000C00C0000000000000000000CCCC000000000000001
101000001010001000100100000001010000000000000000001
101000001010001000100100000001010000000000000000001
101000001010001000100100000001010000000000000000001
101000001010001000100100000001000000000000000000001
101000001000001000100C000000000000000000010000C0001
101000001000001000100C00000000000000000001000000001
101000000000101000100C00000000000000000001000000001
101000000000101000100C00000000011111111111000000001
101000000010101000100100000001010000000000000000001
101000000010100000100100000001010000000000000000001
101000001010100000100100000001000000000000C00000001
101000001010100000100100000001000000000000000000001
101000001010000000111100000000000000000000000000001
101000001010001000000100000000000000000000000000001
101000001010000000000100000000010000000000000000001
101000000010000000000100000000010000000000000000001
101000000010000000000100000001000000000000000000001
1010000000100000001001000000011111111111111000C0001
101000000010001000100100000001000000000000000000001
101000001010001000100100000001000000000000000000001
1C1001001010101000100100C00001010000000000000000001
111111111111111111111111111111111111111111111111111