1111111
1P00EC1
1000001
100C001
1111111